11111111111111111111
100C000010000C00P001
1C000000110000000001
111111C0010000111111
10000111010000100001
100C0010000000000001
100C1110100001011001
10000000100C0001E001
11111111111111111111
11111111111111111111
