1111111111111
1P00000C000E1
1010011111001
10C1100C00001
100011E000C01
1111111111111