1111111111111
1001000000001
10000111110C1
100011E000001
1111111111111